|------------------------------------------------------------|
|                                                            |
|         #                                       ########   |
|                                                            |
|                 ###                                        |
|       ##                                                   |
|                                                            |
|  ###                                                       |
|        #########                                           |
|------------------------------------------------------------|
